1/20190101
1/20190101
1/20190101
1/20190101
1/20190105
1/20190106
1/20190107
1/20190108
1/20190109
1/20190101
1/20190111
1/20190112
1/20190113
1/20190114
1/20190115
1/20190116
1/20190117
1/20190118
1/20190119
1/20190120
1/20190121
1/20190122
1/20190123
1/20190124
1/20190125
1/20190126
1/20190127
1/20190128
1/20190129
1/20190130
1/20190131
2/20190101
2/20190102
2/20190103
2/20190104
2/20190105
2/20190106
2/20190107
2/20190108
2/20190109
2/20190110
2/20190111
2/20190112
2/20190113
2/20190114
2/20190115
2/20190116
2/20190117
2/20190118
2/20190122
2/20190122
2/20190121
2/20190122
2/20190123
2/20190124
2/20190125
2/20190126
2/20190127
2/20190128
2/20190129
2/20190130
2/20190122
3/20190101
3/20190102
3/20190103
3/20190129
3/20190105
3/20190106
3/20190107
3/20190108
3/20190109
3/20190110
3/20190111
3/20190112
3/20190113
3/20190114
3/20190115
3/20190116
3/20190117
3/20190118
3/20190119
3/20190120
3/20190121
3/20190122
3/20190123
3/20190124
3/20190129
3/20190126
3/20190127
3/20190129
3/20190129
3/20190126
3/20190131
4/20190101
4/20190102
4/20190103
4/20190104
4/20190105
4/20190106
4/20190107
4/20190108
4/20190109
4/20190110
4/20190111
4/20190112
4/20190113
4/20190114
4/20190115
4/20190116
4/20190117
4/20190118
4/20190119
4/20190120
4/20190121
4/20190126
4/20190123
4/20190124
4/20190125
4/20190126
4/20190126
4/20190126
4/20190129
4/20190130
4/20190131
